H - Hydrogen - Водород
He - Helium - Гелий
Li - Lithium - Литий
Be - Beryllium - Бериллий
B - Boron - Бор
C - Carbon - Углерод
N - Nitrogen - Азот
O - Oxygen - Кислород
F - Fluorine - Фтор
Ne - Neon - Неон
Na - Sodium - Натрий
Mg - Magnesium - Магний
Al - Aluminium - Алюминий
Si - Silicon - Кремний
P - Phosphorus - Фосфор
S - Sulfur - Сера
Cl - Chlorine - Хлор
Ar - Argon - Аргон
K - Potassium - Калий
Ca - Calcium - Кальций
Sc - Scandium - Скандий
Ti - Titanium - Титан
V - Vanadium - Ванадий
Cr - Chromium - Хром
Mn - Manganese - Марганец
Fe - Iron - Железо
Co - Cobalt - Кобальт
Ni - Nickel - Никель
Cu - Copper - Медь
Zn - Zinc - Цинк
Ga - Gallium - Галлий
Ge - Germanium - Германий
As - Arsenic - Мышьяк
Se - Selenium - Селен
Br - Bromine - Бром
Kr - Krypton - Криптон
Rb - Rubidium - Рубидий
Sr - Strontium - Стронций
Y - Yttrium - Иттрий
Zr - Zirconium - Цирконий
Nb - Niobium - Ниобий
Mo - Molybdenum - Молибден
Tc - Technetium - Технеций
Ru - Ruthenium - Рутений
Rh - Rhodium - Родий
Pd - Palladium - Палладий
Ag - Silver - Серебро
Cd - Cadmium - Кадмий
In - Indium - Индий
Sn - Tin - Олово
Sb - Antimony - Сурьма
Te - Tellurium - Теллур
I - Iodine - Иод
Xe - Xenon - Ксенон
Cs - Caesium - Цезий
Ba - Barium - Барий
La - Lanthanum - Лантан
Ce - Cerium - Церий
Pr - Praseodymium - Празеодим
Nd - Neodymium - Неодим
Pm - Promethium - Прометий
Sm - Samarium - Самарий
Eu - Europium - Европий
Gd - Gadolinium - Гадолиний
Tb - Terbium - Тербий
Dy - Dysprosium - Диспрозий
Ho - Holmium - Гольмий
Er - Erbium - Эрбий
Tm - Thulium - Тулий
Yb - Ytterbium - Иттербий
Lu - Lutetium - Лютеций
Hf - Hafnium - Гафний
Ta - Tantalum - Тантал
W - Tungsten - Вольфрам
Re - Rhenium - Рений
Os - Osmium - Осмий
Ir - Iridium - Иридий
Pt - Platinum - Платина
Au - Gold - Золото
Hg - Mercury - Ртуть
Tl - Thallium - Таллий
Pb - Lead - Свинец
Bi - Bismuth - Висмут
Po - Polonium - Полоний
At - Astatine - Астат
Rn - Radon - Радон
Fr - Francium - Франций
Ra - Radium - Радий
Ac - Actinium - Актиний
Th - Thorium - Торий
Pa - Protactinium - Протактиний
U - Uranium - Уран
Np - Neptunium - Нептуний
Pu - Plutonium - Плутоний
Am - Americium - Америций
Cm - Curium - Кюрий
Bk - Berkelium - Берклий
Cf - Californium - Калифорний
Es - Einsteinium - Эйнштейний
Fm - Fermium - Фермий
Md - Mendelevium - Менделевий
No - Nobelium - Нобелий
Lr - Lawrencium - Лоуренсий
Rf - Rutherfordium - Резерфордий
Db - Dubnium - Дубний
Sg - Seaborgium - Сиборгий
Bh - Bohrium - Борий
Hs - Hassium - Хассий
Mt - Meitnerium - Мейтнерий
Ds - Darmstadtium - Дармштадтий
Rg - Roentgenium - Рентгений
Cn - Copernicium - Коперниций
Nh - Nihonium - Нихоний
Fl - Flerovium - Флеровий
Mc - Moscovium - Московий
Lv - Livermorium - Ливерморий
Ts - Tennessine - Тенессин
Og - Oganesson - Оганессон